#Map
......................
.++++++++++++++++++++.
s------------------++.
.+++++++++++++++++-++.
.++++----+++-------++.
.++++-++-+++-++++++++.
.++++-++-+++-++++++++.
.++++-++-----++++++++.
.++++-+++++++++++++++.
.++++-+++++++++++++++.
.++++-+++++++++++++++.
.++++-+++++++++++++++.
.++++-+++++++++++++++.
.++++-+++++++++++++++.
.++++-+++++++++++++++.
.++++-+++++++++++++++.
.....b...............

// "+" = ground, - = enemyRoute, . = border, b = playerBase * = wayPoint/corner